101123456
200000000
300312345
40400000p
505000700
606000000